
NO	./textures/bricks.png

SO	 ./textures/rockwall.png

WE	  ./textures/woodplanks.png

EA	 ./textures/woodplanks2.png

F 0,0,255

C 0,255,0

11111111111111111
10000000000000001
10000000000000001111
10000000N00000001111
10000000000000001111
10000000000000001
11111111111111111
